27 27 27 27 27 27 27 27 27 27 27 27 27 27 27 27 27 27 27 27 27 27 27 27 27 27 27 27 27 27 27 27 27 27 27 27 27 27 27 27 27 27 27 27 27 27 27 27 27 27 
27 27 27 27 27 27 27 27 27 28 27 27 27 27 27 27 27 27 27 27 27 27 27 27 27 27 27 27 27 27 27 27 27 27 27 27 27 27 27 27 27 27 27 27 27 27 27 27 27 27 
27 27 27 27 27 27 27 27 27 27 27 27 27 27 27 27 27 27 27 27 27 27 27 27 27 27 27 27 27 27 27 27 27 27 27 27 27 27 27 27 27 27 27 27 27 27 27 27 27 27 
27 27 27 28 27 27 27 27 27 27 27 27 27 27 27 27 27 27 27 27 27 27 27 27 27 27 27 28 27 27 27 27 27 27 27 28 27 27 27 27 27 27 27 27 27 27 27 27 27 27 
27 27 27 27 27 27 28 27 27 27 27 27 27 27 27 27 27 28 27 27 27 27 28 27 27 27 27 27 27 27 27 27 27 27 27 27 27 27 27 27 27 27 27 27 27 27 27 27 27 27 
27 27 27 27 27 27 27 27 27 27 27 27 28 27 27 27 27 27 27 27 27 27 27 27 27 27 27 27 27 28 27 28 27 27 27 27 27 27 27 27 27 27 27 27 27 27 27 27 27 27 
27 27 27 27 27 27 27 27 28 26 26 26 26 26 26 26 29 27 28 26 26 26 26 26 26 26 26 29 27 27 27 28 26 26 26 26 26 26 26 26 26 26 29 27 27 27 27 27 27 27 
27 28 27 27 27 27 27 27 33 34 32 32 32 32 32 34 34 26 27 34 28 28 28 28 28 28 28 34 26 26 26 27 34 28 30 28 28 28 28 28 28 37 31 32 27 27 28 27 27 27 27 
27 27 27 27 27 27 27 27 33 34 32 26 26 26 32 34 34 34 34 34 28 29 30 30 30 31 28 34 34 34 34 34 34 34 26 30 30 30 30 30 30 34 32 27 27 27 27 27 27 27 
27 27 27 27 27 27 27 27 33 34 32 26 36 26 32 34 34 34 34 34 28 32 27 27 27 33 28 34 34 34 34 34 34 34 26 30 30 30 30 30 30 34 32 27 27 27 27 28 27 27 
27 27 27 27 27 27 27 27 33 34 32 26 26 26 32 34 34 34 34 34 28 32 27 27 27 33 28 34 34 34 34 34 34 34 26 30 30 30 30 30 30 34 32 28 27 27 27 27 27 27 
27 27 28 27 27 27 27 27 33 34 32 26 26 26 32 34 34 34 34 34 28 34 26 26 26 27 28 34 34 34 34 34 34 34 26 30 30 30 30 30 30 34 32 27 27 27 27 27 27 27 
27 27 27 27 27 28 27 27 33 34 32 32 26 32 32 34 34 34 34 34 28 28 30 28 31 28 28 28 28 28 28 28 28 28 32 32 32 33 30 31 32 33 32 27 27 27 27 27 27 27 
27 27 27 27 27 27 27 27 33 34 34 34 28 34 34 34 34 34 34 34 34 34 26 30 34 34 34 34 34 34 34 34 34 34 34 34 34 26 30 34 29 30 31 27 27 27 28 27 27 27 
27 27 27 27 27 27 27 27 30 31 34 34 28 34 34 34 34 34 34 34 34 34 26 30 34 34 34 34 34 34 34 34 34 34 34 34 34 26 30 34 32 27 27 27 27 27 27 27 27 27 
27 28 27 27 27 27 27 28 27 33 34 34 28 34 34 34 34 34 34 34 34 34 26 30 34 34 34 34 34 34 34 34 34 34 34 34 34 26 30 34 32 28 27 27 27 27 27 27 27 27 
27 27 27 27 27 27 27 27 28 27 34 34 28 34 34 34 34 34 34 34 34 34 26 30 34 28 28 28 34 34 34 34 34 34 34 34 34 26 30 34 32 27 27 28 27 27 27 27 27 27 
27 27 27 27 27 27 27 28 27 34 34 34 28 34 34 34 34 34 34 34 34 34 26 30 34 34 34 34 34 34 34 34 34 34 34 30 28 29 30 34 32 27 27 27 27 27 27 27 27 27 
27 27 27 27 27 27 27 33 34 34 28 28 28 34 34 34 34 34 34 34 34 34 26 30 34 34 34 34 34 34 34 34 34 34 34 26 30 30 30 34 32 27 27 27 27 27 28 27 27 27 
27 27 27 27 27 28 27 33 34 34 28 34 34 34 34 34 34 34 34 34 34 28 26 30 34 28 34 34 34 34 34 34 34 34 34 26 30 31 32 33 32 27 27 27 27 27 27 27 27 27 
27 27 27 27 27 27 27 33 34 34 28 34 34 28 30 28 28 28 28 28 28 28 29 30 27 28 28 28 28 31 34 34 34 30 28 29 30 34 28 34 32 27 27 28 27 27 27 27 27 27 
27 27 27 28 27 27 27 33 34 34 28 34 34 28 26 30 30 30 30 30 30 30 30 30 30 30 30 30 30 34 28 28 28 26 30 30 30 34 28 29 31 27 27 27 27 27 27 27 27 27 
27 27 27 27 27 27 27 33 34 34 28 34 34 28 32 32 32 32 32 32 32 32 33 30 31 32 32 32 32 33 34 34 34 32 32 33 30 34 29 32 27 27 28 27 27 27 27 27 27 27 
27 27 27 27 27 27 27 30 31 34 28 34 34 28 34 34 34 34 34 34 34 28 26 30 34 28 34 34 34 34 34 34 34 34 34 26 30 34 28 32 27 27 27 27 27 27 27 27 27 27 
27 27 27 27 27 27 27 27 33 34 28 34 34 28 34 34 34 34 34 34 34 34 26 30 34 34 34 34 34 34 34 34 34 34 34 26 30 34 28 32 27 27 27 27 27 27 27 27 27 27 
27 27 27 27 27 27 27 27 27 34 28 34 34 28 28 34 34 34 34 34 34 34 26 30 34 34 34 34 34 34 34 34 34 34 34 26 30 34 28 32 27 27 27 27 27 27 28 27 27 27 
27 27 27 28 27 27 27 33 34 34 28 34 34 34 28 34 34 34 34 34 34 34 26 30 34 34 34 34 34 34 34 34 34 34 34 26 30 34 28 32 27 27 27 27 27 27 27 27 27 27 
27 27 27 27 27 27 27 33 34 34 28 34 34 34 28 34 34 34 34 34 34 34 26 30 34 28 28 28 34 34 34 34 34 34 34 26 30 34 28 32 27 27 27 27 27 27 27 27 27 27 
27 27 27 27 27 27 27 33 34 34 28 34 34 34 28 34 34 34 34 34 34 34 26 30 34 34 34 28 34 34 34 34 34 34 34 26 30 34 28 32 27 27 28 27 27 27 27 27 27 27 
27 27 28 27 27 27 27 33 34 34 28 28 28 28 28 28 34 34 34 34 34 34 26 30 34 34 34 28 34 34 28 34 34 34 34 32 32 33 28 32 27 27 27 27 27 27 27 27 27 27 
27 27 27 27 27 27 27 33 34 34 28 29 28 28 28 34 34 34 34 34 34 26 30 34 34 34 28 34 34 28 34 34 34 34 34 28 34 29 31 27 27 27 27 27 27 27 27 27 27 27
27 27 27 27 27 27 28 30 31 34 28 28 28 28 28 28 34 34 34 34 34 34 26 30 34 34 34 28 28 28 28 34 34 34 34 34 28 28 32 27 28 27 27 27 27 27 27 27 27 27 
27 27 27 27 27 27 27 27 33 34 28 28 28 29 28 28 34 34 34 34 34 34 26 30 34 34 34 34 34 34 34 34 34 34 34 28 28 28 32 27 27 27 27 27 27 27 27 28 27 27 
27 27 27 27 27 27 27 27 33 34 28 28 28 28 28 28 34 34 34 34 34 34 26 30 34 34 34 34 34 34 34 34 34 34 34 28 28 29 32 27 27 27 27 27 27 27 27 27 27 27 
27 27 27 27 28 27 27 27 33 34 28 28 28 28 28 28 34 34 34 34 34 34 26 30 34 34 34 34 34 34 34 34 34 34 34 28 28 28 32 27 27 27 27 27 27 27 27 27 27 27 
27 27 27 27 27 27 27 28 27 34 34 34 34 34 34 34 34 34 34 34 34 34 32 32 33 34 34 34 34 34 34 34 34 34 34 28 28 28 34 29 27 27 27 27 27 27 27 27 27 27 
27 27 27 27 27 27 27 33 34 34 34 34 34 34 34 34 34 34 34 34 28 28 28 28 28 28 28 34 34 34 34 34 34 34 28 28 28 28 28 34 29 27 27 28 27 27 27 27 27 27 
27 27 27 27 27 27 27 33 34 34 34 34 34 34 34 34 34 34 34 28 28 28 28 29 28 28 28 28 34 34 28 34 34 28 28 29 28 28 28 28 32 27 27 27 27 27 27 27 27 27 
27 27 27 27 27 27 27 33 34 34 34 34 34 34 34 34 34 34 34 28 28 28 28 28 28 28 28 28 34 34 34 34 28 28 28 28 28 28 28 28 32 27 27 27 27 27 27 27 27 27 
27 27 27 27 27 27 27 33 34 34 33 34 34 34 34 34 34 34 34 28 28 28 28 28 28 28 29 28 28 34 34 34 28 28 28 28 28 34 28 29 32 27 27 27 27 27 27 27 27 27 
27 27 27 27 27 28 27 33 34 34 28 34 34 28 28 28 28 28 28 28 29 28 28 28 28 28 28 28 28 28 28 28 28 28 34 28 28 28 28 28 32 27 27 27 27 27 27 27 27 27 
27 27 27 27 27 27 27 33 34 34 28 28 28 28 34 29 30 30 31 28 28 28 28 28 28 28 28 29 30 30 31 28 28 28 28 28 28 28 28 28 32 27 27 27 27 27 27 27 27 27 
27 28 27 27 27 27 27 33 34 34 34 34 34 34 29 31 27 27 30 31 28 28 28 28 28 28 29 31 27 27 33 28 28 34 28 28 34 28 28 28 32 27 27 27 27 27 28 27 27 27 
27 27 27 27 27 27 27 30 30 30 30 30 30 30 31 27 27 27 27 30 30 30 30 30 30 30 31 27 27 27 30 31 28 28 28 28 28 28 29 30 31 27 28 27 27 27 27 27 27 27 
27 27 27 27 27 27 27 27 27 27 27 27 27 27 28 27 27 27 27 27 27 27 27 27 27 27 27 27 28 27 27 30 30 30 30 30 30 30 31 27 27 27 27 27 27 27 27 27 27 27 
27 27 27 27 28 27 27 27 27 27 27 27 27 27 27 27 27 27 27 27 27 27 27 27 27 27 27 27 27 27 27 27 28 27 27 27 27 27 27 28 27 27 27 27 27 27 27 27 27 27 
27 27 27 27 27 27 27 27 27 28 27 27 27 27 27 27 27 27 27 27 27 27 27 28 27 27 27 27 27 27 27 27 27 27 27 27 27 27 27 27 27 27 27 27 27 28 27 27 27 27 
27 27 27 27 27 27 27 27 27 27 27 27 27 27 27 27 27 27 27 27 27 27 27 27 27 27 27 27 27 27 27 27 27 27 27 27 27 27 27 27 27 27 27 27 27 27 27 27 27 27 
27 27 27 27 27 27 27 27 27 27 27 27 27 27 27 27 27 27 27 27 27 27 27 27 27 27 27 27 27 27 27 27 27 27 27 27 27 27 27 27 27 27 27 27 27 27 27 27 27 27 
27 27 27 27 27 27 27 27 27 27 27 27 27 27 27 27 27 27 27 27 27 27 27 27 27 27 27 27 27 27 27 27 27 27 27 27 27 27 27 27 27 27 27 27 27 27 27 27 27 27 
